american_football.football_historical_coach_position	american_football.football_coach	american_football.football_coach_position
american_football.game_passing_statistics	american_football.football_player	american_football.football_game
american_football.game_receiving_statistics	american_football.football_game	american_football.football_player
american_football.game_rushing_statistics	american_football.football_player	american_football.football_game
american_football.player_game_statistics	american_football.football_player	sports.sports_league_season
american_football.player_passing_statistics	american_football.football_player	sports.sports_league_season
american_football.player_receiving_statistics	sports.sports_league_season	american_football.football_player
american_football.player_rushing_statistics	american_football.football_player	sports.sports_league_season
architecture.occupancy	architecture.building	architecture.building_occupant
architecture.ownership	architecture.structure	architecture.architectural_structure_owner
award.award_judging_term	award.award_category	award.award_judge
award.category_ceremony_relationship	award.recurring_award_ceremony	award.award_category
award.ranking	award.ranked_list	award.ranked_item
base.adoption.adoption	base.adoption.adopted_person	base.adoption.adopter
base.americancomedy.comedy_group_membership	base.americancomedy.comedy_group_member	base.americancomedy.comedy_group
baseball.baseball_historical_managerial_position	baseball.baseball_team	baseball.baseball_manager
baseball.baseball_team_stats	sports.sports_league_season	baseball.baseball_team
base.bioventurist.sales	base.bioventurist.science_or_technology_company	finance.currency
base.brothels.prostitute_employment_tenure	base.brothels.prostitute	base.brothels.brothel
base.catalog.music_catalog_entry	base.catalog.cataloged_composition	base.catalog.music_catalog
base.column.column_periodical_duration	base.column.column_publisher	base.column.column
base.column.column_syndicate_duration	base.column.column	base.column.column_syndicate
base.cycleroute.cycle_route_connection	base.cycleroute.cycle_route	location.location
base.dancegroups.dance_group_membership	base.dancegroups.dance_group	base.dancegroups.dance_group_member
base.datedlocationtest.dated_location_break_up	base.datedlocationtest.dated_location_test	base.datedlocationtest.dated_location_test
base.datedlocationtest.dated_location_merger	base.datedlocationtest.dated_location_test	base.datedlocationtest.dated_location_test
base.datedlocationtest.dated_location_split	base.datedlocationtest.dated_location_test	base.datedlocationtest.dated_location_test
base.ecology.symbiotic_relationship	base.ecology.food_web_member	base.ecology.type_of_symbiotic_relationship
base.entertainmentutilities.nomination_metadata	award.award_category	base.entertainmentutilities.nomination_page_metadata
base.esports.e_sports_roster_position	base.esports.e_sports_team	base.esports.e_sports_athlete
base.famouspets.pet_ownership	base.famouspets.pet_owner	base.famouspets.pet
base.foodily.recipe_ingredient	food.ingredient	food.culinary_measure
base.formula1.formula_1_championship_standing	base.formula1.formula_1_season	base.formula1.formula_1_driver
base.government2.legislative_position_held	government.governmental_body	government.legislative_session
base.greatfilms.ranking	base.greatfilms.ranked_item	base.greatfilms.ranked_list
base.handball.handball_disciplinary_action	base.handball.handball_player	base.handball.handball_match
base.handball.handball_team_match_participation	base.handball.handball_team	base.handball.handball_match
base.iceandfire.house_lordship	base.iceandfire.house_lord	base.iceandfire.noble_house
base.iceandfire.house_weapon_stint	base.iceandfire.noble_house	base.iceandfire.notable_weapon
base.iceandfire.possession	base.iceandfire.person	base.iceandfire.notable_object
base.jamesbond007.villain_fate	base.jamesbond007.bond_movie_villain	base.jamesbond007.bond_film
base.jamesbond007.villain_objective	base.jamesbond007.bond_movie_villain	base.jamesbond007.bond_film
base.localfood.produce_availability	base.localfood.food_producing_region	base.localfood.produce
base.lostbase.episode_character_relationship	base.lostbase.lost_character	base.lostbase.lost_episode
base.marchmadness.ncaa_basketball_final_four_broadcaster	people.person	base.marchmadness.ncaa_basketball_tournament
base.marchmadness.ncaa_tournament_seed	base.marchmadness.ncaa_basketball_team	base.marchmadness.ncaa_basketball_tournament
base.musicfestival.artist_festival_relationship	music.artist	base.musicfestival.music_festival_tour
base.nascar.nascar_race_result	base.nascar.nascar_driver	base.nascar.nascar_race_instance
base.ontologies.ontology_class_mapping	base.ontologies.ontology_class	base.ontologies.ontology
base.ontologies.ontology_instance_mapping	base.ontologies.ontology	base.ontologies.ontology_instance
base.patronage.patron_client_relationship	base.patronage.patronage_product	base.patronage.patron
base.peleton.cycling_team_membership	base.peleton.cycling_team_professional	base.peleton.cyclist
base.peleton.historical_cycling_roster_position	base.peleton.cyclist	base.peleton.cycling_team_professional
base.petbreeds.dog_city_relationship	base.petbreeds.dog_breed	base.petbreeds.city_with_dogs
base.politicalconventions.pres_delegate_vote_tally	base.politicalconventions.political_convention	base.politicalconventions.primary_candidate
base.politicalconventions.vp_delegate_vote_tally	base.politicalconventions.political_convention	base.politicalconventions.primary_candidate
base.popstra.hangout	base.popstra.celebrity	base.popstra.business_location
base.popstra.legal_dispute	base.popstra.celebrity	base.popstra.celebrity
base.popstra.operation	base.popstra.procedure	base.popstra.celebrity
base.popstra.party_attendance_person	base.popstra.celebrity	base.popstra.party
base.popstra.product_choice	base.popstra.product	base.popstra.celebrity
base.popstra.public_insult	base.popstra.celebrity	base.popstra.celebrity
base.popstra.religion_choice	base.popstra.religion	base.popstra.celebrity
base.popstra.restaurant_choice	base.popstra.celebrity	base.popstra.restaurant
base.popstra.substance_abuse	base.popstra.substance	base.popstra.celebrity
base.popstra.support	base.popstra.organization	base.popstra.celebrity
base.popstra.vacation_choice	base.popstra.location	base.popstra.celebrity
base.prison.imprisonment	base.prison.prison	base.prison.prisoner
base.productplacement.product_placement	base.productplacement.product_placing_media	base.productplacement.product_placed_brand
base.represent.agent_celebrity_representation	celebrities.celebrity	base.represent.agent
base.rugby.rugby_club_tenure	base.rugby.rugby_player	base.rugby.rugby_club
base.rugby.rugby_coaching_tenure	base.rugby.rugby_coach	base.rugby.rugby_club
base.saturdaynightlive.snl_season_tenure	base.saturdaynightlive.snl_season	base.saturdaynightlive.snl_cast_member
base.schemastaging.coach_athlete_relationship	base.schemastaging.athlete_extra	base.schemastaging.sports_coach
base.schemastaging.heya_wrestler_relationship	base.schemastaging.heya	base.schemastaging.sumo_wrestler
base.schemastaging.religion_statistics	base.schemastaging.statistical_region_extra	religion.religion
base.schemastaging.sports_league_season_ranking	base.schemastaging.sports_league_season_extra	base.schemastaging.sports_team_extra
base.schemastaging.team_training_ground_relationship	base.schemastaging.sports_team_extra	base.schemastaging.sports_facility_extra
base.skateboarding.brand_distribution_relationship	base.skateboarding.skateboarding_brand	base.skateboarding.distribution_company
base.surfing.asp_world_tour_rating	base.surfing.asp_world_tour	base.surfing.surfer
base.survivor.survivor_placement	base.survivor.survivor_episode	base.survivor.survivor_contestant
base.thoroughbredracing.horse_owner_relationship	base.thoroughbredracing.thoroughbred_racehorse	base.thoroughbredracing.thoroughbred_racehorse_owner
base.thoroughbredracing.horse_trainer_relationship	base.thoroughbredracing.thoroughbred_racehorse	base.thoroughbredracing.thoroughbred_racehorse_trainer
base.tournaments.match_competitor_relationship	base.tournaments.tournament_competitor	base.tournaments.tournament_match
base.trixtypes.stat	base.trixtypes.daily_stats	base.trixtypes.stat_property
base.webvideo.internet_video_producer_credit	base.webvideo.internet_video	base.webvideo.internet_video_producer
base.webvideo.internet_video_series_producer_credit	base.webvideo.internet_video_series	base.webvideo.internet_video_producer
base.wrestling.championship_title_reign	base.wrestling.solo_wrestler_or_team	base.wrestling.championship_title
base.x2010fifaworldcupsouthafrica.group_qualifying_teams	base.x2010fifaworldcupsouthafrica.world_cup_qualification_group	base.x2010fifaworldcupsouthafrica.world_cup_participation
base.yalebase.secret_society_membership	base.yalebase.secret_society	base.yalebase.secret_society_member
basketball.basketball_historical_coach_position	basketball.basketball_team	basketball.basketball_coach
basketball.basketball_team_stats	sports.sports_league_season	basketball.basketball_team
biology.animal_ownership	biology.animal_owner	biology.owned_animal
biology.hybrid_parentage	biology.hybrid_parent_classification	biology.hybrid
boats.ship_ownership	boats.ship_owner	boats.ship
book.contents	book.publication	book.published_work
book.journal_publication	book.journal_article	book.journal
book.periodical_publisher_period	book.periodical	book.periodical_publisher
book.publisher_imprint_tenure	book.publishing_company	book.publishing_company
broadcast.radio_affiliation_duration	broadcast.radio_network	broadcast.radio_station
broadcast.tv_affiliation_duration	tv.tv_network	broadcast.tv_station
business.asset_ownership	business.asset_owner	business.asset
business.brand_colors	business.brand	visual_art.color
business.company_brand_relationship	business.consumer_company	business.brand
business.company_product_line_relationship	business.product_line	business.consumer_company
business.company_product_relationship	business.consumer_company	business.consumer_product
business.market_size	finance.currency	location.location
business.sponsorship	business.sponsored_recipient	business.sponsor
celebrities.substance_abuse_problem	celebrities.abused_substance	celebrities.celebrity
chemistry.solubility_relationship	chemistry.chemical_compound	chemistry.chemical_compound
comic_strips.comic_strip_creator_duration	comic_strips.comic_strip_creator	comic_strips.comic_strip
comic_strips.comic_strip_syndicate_duration	comic_strips.comic_strip_syndicate	comic_strips.comic_strip
computer.os_compatibility	computer.operating_system	computer.computer
computer.software_compatibility	computer.software	computer.operating_system
cricket.cricket_roster_bowling	cricket.cricket_roster	cricket.cricket_bowler
dining.restaurant_chef_association	dining.restaurant	dining.chef
education.academic_post	education.academic_institution	education.academic_post_title
fashion.designer_label_association	fashion.fashion_label	fashion.fashion_designer
film.film_cut	location.location	film.film
film.film_regional_release_date	location.location	film.film
film.personal_film_appearance	film.film	film.person_or_entity_appearing_in_film
finance.exchange_rate	finance.currency	finance.currency
food.beer_containment	food.beer	food.beer_container
freebase.metaweb_api_service_argument	freebase.metaweb_api_argument_format	freebase.metaweb_api_service
government.legislative_election_results	government.political_party	government.governmental_body
government.national_anthem_of_a_country	location.country	government.national_anthem
location.location_symbol_relationship	government.governmental_jurisdiction	location.offical_symbol_variety
location.partial_containment_relationship	location.location	location.location
measurement_unit.dated_money_value	dataworld.information_source	finance.currency
military.military_combatant_group	military.military_conflict	military.military_combatant
military.military_posting	military.military_person	military.military_post
military.military_post_use	military.military_post	military.armed_force
music.conducting_tenure	music.conductor	music.conducted_ensemble
music.music_video_performance	music.music_video	music.music_video_performer
music.track_contribution	music.performance_role	music.artist
olympics.olympic_city_bid	olympics.olympic_bidding_city	olympics.olympic_games
opera.opera_character_voice	opera.opera_character	opera.opera
opera.opera_production_venue_relationship	opera.opera_house	opera.opera_production
organization.leadership	business.board_member	organization.role
organization.organization_membership	organization.organization_member	organization.membership_organization
people.group_membership	people.group	people.person
people.human_measurement	people.measured_body_part	people.measured_person
people.marriage	people.person	location.location
rail.railway_operator_relationship	rail.railway	rail.railway_operator
religion.place_of_worship_historical_use	religion.place_of_worship	religion.religion
religion.religious_leadership_jurisdiction_appointment	religion.religious_leadership_title	religion.religious_leadership_jurisdiction
royalty.noble_title_tenure	royalty.noble_title	royalty.noble_person
royalty.system_order_relationship	royalty.system_of_nobility	royalty.order_of_chivalry
royalty.system_rank_relationship	royalty.noble_rank	royalty.system_of_nobility
royalty.system_title_relationship	royalty.system_of_nobility	royalty.noble_title
soccer.football_disciplinary_action	soccer.football_player	soccer.football_match
soccer.football_player_stats	soccer.football_player	soccer.football_team
soccer.football_team_management_tenure	soccer.football_team	soccer.football_team_manager
sports.pro_sports_played	sports.sport	sports.pro_athlete
sports.sports_team_coach_tenure	sports.coaching_position	sports.sports_team
sports.sports_team_roster	sports.sports_team	sports.pro_athlete
sports.sports_team_season_record	sports.sports_league_season	sports.sports_team
sports.team_venue_relationship	sports.sports_facility	sports.sports_team
tennis.tennis_tournament_championship	tennis.tennis_tournament	tennis.tennis_tournament_champion
theater.theater_production_venue_relationship	theater.theater_production	theater.theater
transportation.road_starting_point	transportation.road	location.location
travel.hotel_grade	travel.hotel_grading_authority	travel.hotel
travel.hotel_guest_visit	travel.hotel	people.person
travel.travel_destination_monthly_climate	travel.travel_destination	time.month
tv.tv_guest_personal_appearance	tv.tv_program_guest	tv.tv_series_episode
tv.tv_network_duration	tv.tv_program	tv.tv_network
tv.tv_producer_episode_credit	tv.tv_producer	tv.tv_series_episode
tv.tv_producer_term	tv.tv_program	tv.tv_producer
tv.tv_program_writer_relationship	tv.tv_writer	tv.tv_program
tv.tv_segment_personal_appearance	tv.tv_episode_segment	tv.tv_personality
user.alecf.recreation.park_feature_quantity	user.alecf.recreation.park_feature	user.alecf.recreation.park
user.alexbl.congressional_voting_records.congressional_vote	user.alexbl.congressional_voting_records.congressional_member	user.alexbl.congressional_voting_records.legislative_matter
user.arielb.stalag.prisoners	military.military_combatant	military.military_conflict
user.micahsaul.advertising.ad_campaign_contribution	user.micahsaul.advertising.ad_campaign	user.micahsaul.advertising.ad_contributor
user.micahsaul.advertising.ad_contribution	user.micahsaul.advertising.ad	user.micahsaul.advertising.ad_contributor
user.pak21.default_domain.sports_squad	people.person	sports.sports_team
user.robert.area_codes.coverage	user.robert.area_codes.area_code	location.location
user.robert.default_domain.film_review	film.film	user.robert.default_domain.media_consumer
user.robert.earthquakes.earthquake_nearest_location	user.robert.earthquakes.earthquake	user.robert.earthquakes.earthquake_epicenter
user.sandos.social.has_visited	location.location	user.sandos.social.peer
user.tsegaran.random.taxonomy_entry	user.tsegaran.random.taxonomy_subject	user.tsegaran.random.subject_taxonomy
user.ungzd.default_domain.eurovision_vote	location.country	location.country
user.uoa_it.uoa_it.uoa_collaboration	user.uoa_it.uoa_it.uoa_committee	user.uoa_it.uoa_it.uoa_committee
visual_art.artwork_location_relationship	location.location	visual_art.artwork
visual_art.artwork_owner_relationship	visual_art.artwork	finance.currency
wine.grape_variety_composition	wine.grape_variety	wine.wine
aviation.airline_airport_presence.airport/aviation.airline_airport_presence.airline	aviation.airport	aviation.airline
aviation.airline_airport_presence.cities_served/aviation.airline_airport_presence.airline	location.citytown	aviation.airline
aviation.airline_airport_presence.cities_served/aviation.airline_airport_presence.airport	location.citytown	aviation.airport
aviation.aviation_incident_aircraft_relationship.flight_origin/aviation.aviation_incident_aircraft_relationship.flight_destination	aviation.airport	aviation.airport
aviation.aviation_incident_aircraft_relationship.flight_origin/aviation.aviation_incident_aircraft_relationship.incident	aviation.airport	aviation.airliner_accident
aviation.aviation_incident_aircraft_relationship.flight_origin/aviation.aviation_incident_aircraft_relationship.operator	aviation.airport	aviation.aircraft_owner
aviation.aviation_incident_aircraft_relationship.incident/aviation.aviation_incident_aircraft_relationship.flight_destination	aviation.airliner_accident	aviation.airport
aviation.aviation_incident_aircraft_relationship.incident/aviation.aviation_incident_aircraft_relationship.operator	aviation.airliner_accident	aviation.aircraft_owner
aviation.aviation_incident_aircraft_relationship.operator/aviation.aviation_incident_aircraft_relationship.flight_destination	aviation.aircraft_owner	aviation.airport
award.award_honor.achievement_level/award.award_honor.award	award.award_achievement_level	award.award_category
award.award_honor.achievement_level/award.award_honor.award_winner	award.award_achievement_level	award.award_winner
award.award_honor.achievement_level/award.award_honor.ceremony	award.award_achievement_level	award.award_ceremony
award.award_honor.achievement_level/award.award_honor.honored_for	award.award_achievement_level	award.award_winning_work
award.award_honor.award/award.award_honor.ceremony	award.award_category	award.award_ceremony
award.award_honor.award_winner/award.award_honor.award	award.award_winner	award.award_category
award.award_honor.award_winner/award.award_honor.ceremony	award.award_winner	award.award_ceremony
award.award_honor.award_winner/award.award_honor.honored_for	award.award_winner	award.award_winning_work
award.award_honor.honored_for/award.award_honor.award	award.award_winning_work	award.award_category
award.award_honor.honored_for/award.award_honor.ceremony	award.award_winning_work	award.award_ceremony
award.award_nomination.award/award.award_nomination.award_nominee	award.award_category	award.award_nominee
award.award_nomination.award/award.award_nomination.nominated_for	award.award_category	award.award_nominated_work
award.award_nomination.award_nominee/award.award_nomination.nominated_for	award.award_nominee	award.award_nominated_work
award.award_nomination.ceremony/award.award_nomination.award	award.award_ceremony	award.award_category
award.award_nomination.ceremony/award.award_nomination.award_nominee	award.award_ceremony	award.award_nominee
award.award_nomination.ceremony/award.award_nomination.nominated_for	award.award_ceremony	award.award_nominated_work
award.hall_of_fame_induction.category/award.hall_of_fame_induction.hall_of_fame	award.hall_of_fame_induction_category	award.hall_of_fame
award.hall_of_fame_induction.inductee/award.hall_of_fame_induction.category	award.hall_of_fame_inductee	award.hall_of_fame_induction_category
award.hall_of_fame_induction.inductee/award.hall_of_fame_induction.hall_of_fame	award.hall_of_fame_inductee	award.hall_of_fame
award.long_list_nomination.nominated_work/award.long_list_nomination.award	award.long_listed_work	award.award_category
award.long_list_nomination.nominated_work/award.long_list_nomination.nominee	award.long_listed_work	award.long_list_nominee
award.long_list_nomination.nominee/award.long_list_nomination.award	award.long_list_nominee	award.award_category
base.animalnames.animal_specific_name_relationship.gender/base.animalnames.animal_specific_name_relationship.animal	base.animalnames.animal_gender	base.animalnames.animal
base.animalnames.animal_specific_name_relationship.specific_name/base.animalnames.animal_specific_name_relationship.animal	base.animalnames.gender_or_age_specific_animal_name	base.animalnames.animal
base.animalnames.animal_specific_name_relationship.specific_name/base.animalnames.animal_specific_name_relationship.gender	base.animalnames.gender_or_age_specific_animal_name	base.animalnames.animal_gender
base.arthist.provenienciaadat.helynev/base.arthist.provenienciaadat.mutargy	base.arthist.helynevek	base.arthist.mutargyak
base.arthist.provenienciaadat.intezmeny/base.arthist.provenienciaadat.helynev	base.arthist.int_zm_nyek	base.arthist.helynevek
base.arthist.provenienciaadat.intezmeny/base.arthist.provenienciaadat.mutargy	base.arthist.int_zm_nyek	base.arthist.mutargyak
base.athletics.athletics_championships_competition_athlete_relationship.athlete_s/base.athletics.athletics_championships_competition_athlete_relationship.country	base.athletics.track_and_field_athlete	base.athletics.athletics_country
base.athletics.athletics_championships_competition_athlete_relationship.athlete_s/base.athletics.athletics_championships_competition_athlete_relationship.event	base.athletics.track_and_field_athlete	base.athletics.athletics_championships_competition
base.athletics.athletics_championships_competition_athlete_relationship.championships/base.athletics.athletics_championships_competition_athlete_relationship.athlete_s	base.athletics.athletics_championships	base.athletics.track_and_field_athlete
base.athletics.athletics_championships_competition_athlete_relationship.championships/base.athletics.athletics_championships_competition_athlete_relationship.country	base.athletics.athletics_championships	base.athletics.athletics_country
base.athletics.athletics_championships_competition_athlete_relationship.championships/base.athletics.athletics_championships_competition_athlete_relationship.event	base.athletics.athletics_championships	base.athletics.athletics_championships_competition
base.athletics.athletics_championships_competition_athlete_relationship.country/base.athletics.athletics_championships_competition_athlete_relationship.event	base.athletics.athletics_country	base.athletics.athletics_championships_competition
base.aubreymaturin.affliction.malady/base.aubreymaturin.affliction.treatment	base.aubreymaturin.malady	base.aubreymaturin.treatment
base.aubreymaturin.affliction.sufferer/base.aubreymaturin.affliction.malady	base.aubreymaturin.character	base.aubreymaturin.malady
base.aubreymaturin.affliction.sufferer/base.aubreymaturin.affliction.treatment	base.aubreymaturin.character	base.aubreymaturin.treatment
baseball.batting_statistics.season/baseball.batting_statistics.player	sports.sports_league_season	baseball.baseball_player
baseball.batting_statistics.team/baseball.batting_statistics.player	baseball.baseball_team	baseball.baseball_player
baseball.batting_statistics.team/baseball.batting_statistics.season	baseball.baseball_team	sports.sports_league_season
baseball.current_coaching_tenure.baseball_coach/baseball.current_coaching_tenure.coaching_position	baseball.baseball_coach	baseball.baseball_coaching_position
baseball.current_coaching_tenure.baseball_team/baseball.current_coaching_tenure.baseball_coach	baseball.baseball_team	baseball.baseball_coach
baseball.current_coaching_tenure.baseball_team/baseball.current_coaching_tenure.coaching_position	baseball.baseball_team	baseball.baseball_coaching_position
baseball.historical_coaching_tenure.baseball_coach/baseball.historical_coaching_tenure.baseball_team	baseball.baseball_coach	baseball.baseball_team
baseball.historical_coaching_tenure.baseball_coach/baseball.historical_coaching_tenure.coaching_position	baseball.baseball_coach	baseball.baseball_coaching_position
baseball.historical_coaching_tenure.baseball_team/baseball.historical_coaching_tenure.coaching_position	baseball.baseball_team	baseball.baseball_coaching_position
baseball.lifetime_batting_statistics.ending_season/baseball.lifetime_batting_statistics.starting_season	sports.sports_league_season	sports.sports_league_season
baseball.lifetime_batting_statistics.last_statistics_season/baseball.lifetime_batting_statistics.ending_season	sports.sports_league_season	sports.sports_league_season
baseball.lifetime_batting_statistics.last_statistics_season/baseball.lifetime_batting_statistics.starting_season	sports.sports_league_season	sports.sports_league_season
baseball.lifetime_batting_statistics.player/baseball.lifetime_batting_statistics.ending_season	baseball.baseball_player	sports.sports_league_season
baseball.lifetime_batting_statistics.player/baseball.lifetime_batting_statistics.last_statistics_season	baseball.baseball_player	sports.sports_league_season
baseball.lifetime_batting_statistics.player/baseball.lifetime_batting_statistics.starting_season	baseball.baseball_player	sports.sports_league_season
base.bioventurist.bv_investment_round.company_invested/base.bioventurist.bv_investment_round.currency	base.bioventurist.science_or_technology_company	finance.currency
base.bioventurist.bv_investment_round.investment_round/base.bioventurist.bv_investment_round.company_invested	venture_capital.investment_round	base.bioventurist.science_or_technology_company
base.bioventurist.bv_investment_round.investment_round/base.bioventurist.bv_investment_round.currency	venture_capital.investment_round	finance.currency
base.bioventurist.bv_investment_round.investment_round/base.bioventurist.bv_investment_round.investors	venture_capital.investment_round	base.bioventurist.bv_venture_investor
base.bioventurist.bv_investment_round.investors/base.bioventurist.bv_investment_round.company_invested	base.bioventurist.bv_venture_investor	base.bioventurist.science_or_technology_company
base.bioventurist.bv_investment_round.investors/base.bioventurist.bv_investment_round.currency	base.bioventurist.bv_venture_investor	finance.currency
base.conservationaction.documented_priority_species.location/base.conservationaction.documented_priority_species.priority_level	base.litcentral.focal_location	base.conservationaction.priority_level
base.conservationaction.documented_priority_species.location/base.conservationaction.documented_priority_species.source	base.litcentral.focal_location	base.conservationaction.priority_source
base.conservationaction.documented_priority_species.source/base.conservationaction.documented_priority_species.priority_level	base.conservationaction.priority_source	base.conservationaction.priority_level
base.conservationaction.documented_priority_species.taxa/base.conservationaction.documented_priority_species.location	base.litcentral.focal_taxa	base.litcentral.focal_location
base.conservationaction.documented_priority_species.taxa/base.conservationaction.documented_priority_species.priority_level	base.litcentral.focal_taxa	base.conservationaction.priority_level
base.conservationaction.documented_priority_species.taxa/base.conservationaction.documented_priority_species.source	base.litcentral.focal_taxa	base.conservationaction.priority_source
base.conservation.protected_species_status.protected_species/base.conservation.protected_species_status.in_list	base.conservation.protected_species	base.conservation.conservation_list
base.conservation.protected_species_status.status_designation/base.conservation.protected_species_status.in_list	base.conservation.conservation_status_designation	base.conservation.conservation_list
base.conservation.protected_species_status.status_designation/base.conservation.protected_species_status.protected_species	base.conservation.conservation_status_designation	base.conservation.protected_species
base.contractbridge.bridge_tournament_standings.first_place/base.contractbridge.bridge_tournament_standings.second_place	base.contractbridge.bridge_player	base.contractbridge.bridge_player
base.contractbridge.bridge_tournament_standings.tournament/base.contractbridge.bridge_tournament_standings.first_place	base.contractbridge.bridge_tournament	base.contractbridge.bridge_player
base.contractbridge.bridge_tournament_standings.tournament/base.contractbridge.bridge_tournament_standings.second_place	base.contractbridge.bridge_tournament	base.contractbridge.bridge_player
base.crime.crime_accusation.accuser/base.crime.crime_accusation.crime	base.crime.crime_accuser	base.crime.crime
base.crime.crime_accusation.accuser/base.crime.crime_accusation.suspect	base.crime.crime_accuser	base.crime.crime_suspect
base.crime.crime_accusation.crime/base.crime.crime_accusation.suspect	base.crime.crime	base.crime.crime_suspect
base.endorsements.newspaper_endorsement.election/base.endorsements.newspaper_endorsement.endorsee	government.election	base.endorsements.endorsee
base.endorsements.newspaper_endorsement.election/base.endorsements.newspaper_endorsement.newspaper	government.election	base.endorsements.endorsing_newspaper
base.endorsements.newspaper_endorsement.endorsee/base.endorsements.newspaper_endorsement.newspaper	base.endorsements.endorsee	base.endorsements.endorsing_newspaper
base.endorsements.personal_endorsement.endorsee/base.endorsements.personal_endorsement.election	base.endorsements.endorsee	government.election
base.endorsements.personal_endorsement.endorsee/base.endorsements.personal_endorsement.endorser	base.endorsements.endorsee	base.endorsements.endorsing_person
base.endorsements.personal_endorsement.endorser/base.endorsements.personal_endorsement.election	base.endorsements.endorsing_person	government.election
base.fictionaluniverse.fictional_inhabitation.inhabitor/base.fictionaluniverse.fictional_inhabitation.inhabited_character	base.fictionaluniverse.fictional_inhabiting_character	base.fictionaluniverse.inhabited_fictional_character
base.fictionaluniverse.fictional_inhabitation.inhabitor/base.fictionaluniverse.fictional_inhabitation.type_of_inhabitation	base.fictionaluniverse.fictional_inhabiting_character	base.fictionaluniverse.fictional_inhabitation_type
base.fictionaluniverse.fictional_inhabitation.type_of_inhabitation/base.fictionaluniverse.fictional_inhabitation.inhabited_character	base.fictionaluniverse.fictional_inhabitation_type	base.fictionaluniverse.inhabited_fictional_character
base.fictionaluniverse.fictional_spaceship_crewman_posting.crewman/base.fictionaluniverse.fictional_spaceship_crewman_posting.position	base.fictionaluniverse.fictional_spaceship_crewman	fictional_universe.character_occupation
base.fictionaluniverse.fictional_spaceship_crewman_posting.spacecraft/base.fictionaluniverse.fictional_spaceship_crewman_posting.crewman	base.fictionaluniverse.fictional_spacecraft	base.fictionaluniverse.fictional_spaceship_crewman
base.fictionaluniverse.fictional_spaceship_crewman_posting.spacecraft/base.fictionaluniverse.fictional_spaceship_crewman_posting.position	base.fictionaluniverse.fictional_spacecraft	fictional_universe.character_occupation
base.firsts.first_achievement.category/base.firsts.first_achievement.achievement	base.firsts.first_achievement_category	base.firsts.achievement
base.firsts.first_achievement.first/base.firsts.first_achievement.achievement	base.firsts.first	base.firsts.achievement
base.firsts.first_achievement.first/base.firsts.first_achievement.category	base.firsts.first	base.firsts.first_achievement_category
base.government2.elected_government_positions_held.district_represented/base.government2.elected_government_positions_held.jurisdiction	government.political_district	government.governmental_jurisdiction
base.government2.elected_government_positions_held.officeholder/base.government2.elected_government_positions_held.district_represented	base.government2.elected_official	government.political_district
base.government2.elected_government_positions_held.officeholder/base.government2.elected_government_positions_held.jurisdiction	base.government2.elected_official	government.governmental_jurisdiction
base.handball.handball_player_match_participation.match/base.handball.handball_player_match_participation.player	base.handball.handball_match	base.handball.handball_player
base.handball.handball_player_match_participation.match/base.handball.handball_player_match_participation.team	base.handball.handball_match	base.handball.handball_team
base.handball.handball_player_match_participation.player/base.handball.handball_player_match_participation.team	base.handball.handball_player	base.handball.handball_team
base.handball.handball_roster_position.player/base.handball.handball_roster_position.position	base.handball.handball_player	base.handball.handball_position
base.handball.handball_roster_position.player/base.handball.handball_roster_position.team	base.handball.handball_player	base.handball.handball_team
base.handball.handball_roster_position.team/base.handball.handball_roster_position.position	base.handball.handball_team	base.handball.handball_position
base.horseracing.race_results.jockey/base.horseracing.race_results.horse	base.horseracing.jockey	base.horseracing.racehorse
base.horseracing.race_results.jockey/base.horseracing.race_results.race	base.horseracing.jockey	base.horseracing.horse_race
base.horseracing.race_results.race/base.horseracing.race_results.horse	base.horseracing.horse_race	base.horseracing.racehorse
base.militaryinfiction.force_strength_in_fiction.combatant/base.militaryinfiction.force_strength_in_fiction.military_conflict	base.militaryinfiction.military_combatant_in_fiction	base.militaryinfiction.military_conflict_in_fiction
base.militaryinfiction.force_strength_in_fiction.combatant/base.militaryinfiction.force_strength_in_fiction.resource	base.militaryinfiction.military_combatant_in_fiction	base.militaryinfiction.military_resource_in_fiction
base.militaryinfiction.force_strength_in_fiction.combatant/base.militaryinfiction.force_strength_in_fiction.unit_if_known	base.militaryinfiction.military_combatant_in_fiction	base.militaryinfiction.military_unit_in_fiction
base.militaryinfiction.force_strength_in_fiction.combatant/base.militaryinfiction.force_strength_in_fiction.work_of_fiction	base.militaryinfiction.military_combatant_in_fiction	fictional_universe.work_of_fiction
base.militaryinfiction.force_strength_in_fiction.resource/base.militaryinfiction.force_strength_in_fiction.military_conflict	base.militaryinfiction.military_resource_in_fiction	base.militaryinfiction.military_conflict_in_fiction
base.militaryinfiction.force_strength_in_fiction.resource/base.militaryinfiction.force_strength_in_fiction.unit_if_known	base.militaryinfiction.military_resource_in_fiction	base.militaryinfiction.military_unit_in_fiction
base.militaryinfiction.force_strength_in_fiction.unit_if_known/base.militaryinfiction.force_strength_in_fiction.military_conflict	base.militaryinfiction.military_unit_in_fiction	base.militaryinfiction.military_conflict_in_fiction
base.militaryinfiction.force_strength_in_fiction.work_of_fiction/base.militaryinfiction.force_strength_in_fiction.military_conflict	fictional_universe.work_of_fiction	base.militaryinfiction.military_conflict_in_fiction
base.militaryinfiction.force_strength_in_fiction.work_of_fiction/base.militaryinfiction.force_strength_in_fiction.resource	fictional_universe.work_of_fiction	base.militaryinfiction.military_resource_in_fiction
base.militaryinfiction.force_strength_in_fiction.work_of_fiction/base.militaryinfiction.force_strength_in_fiction.unit_if_known	fictional_universe.work_of_fiction	base.militaryinfiction.military_unit_in_fiction
base.militaryinfiction.military_casulaties_in_fiction.combatant/base.militaryinfiction.military_casulaties_in_fiction.military_conflict	base.militaryinfiction.military_combatant_in_fiction	base.militaryinfiction.military_conflict_in_fiction
base.militaryinfiction.military_casulaties_in_fiction.combatant/base.militaryinfiction.military_casulaties_in_fiction.work_of_fiction	base.militaryinfiction.military_combatant_in_fiction	fictional_universe.work_of_fiction
base.militaryinfiction.military_casulaties_in_fiction.military_conflict/base.militaryinfiction.military_casulaties_in_fiction.work_of_fiction	base.militaryinfiction.military_conflict_in_fiction	fictional_universe.work_of_fiction
base.militaryinfiction.military_casulaties_in_fiction.unit/base.militaryinfiction.military_casulaties_in_fiction.combatant	base.militaryinfiction.military_unit_in_fiction	base.militaryinfiction.military_combatant_in_fiction
base.militaryinfiction.military_casulaties_in_fiction.unit/base.militaryinfiction.military_casulaties_in_fiction.military_conflict	base.militaryinfiction.military_unit_in_fiction	base.militaryinfiction.military_conflict_in_fiction
base.militaryinfiction.military_casulaties_in_fiction.unit/base.militaryinfiction.military_casulaties_in_fiction.work_of_fiction	base.militaryinfiction.military_unit_in_fiction	fictional_universe.work_of_fiction
base.militaryinfiction.military_character_service.military_force/base.militaryinfiction.military_character_service.military_character	base.militaryinfiction.armed_force_in_fiction	base.militaryinfiction.military_character
base.militaryinfiction.military_character_service.rank/base.militaryinfiction.military_character_service.military_character	base.militaryinfiction.military_rank_in_fiction	base.militaryinfiction.military_character
base.militaryinfiction.military_character_service.rank/base.militaryinfiction.military_character_service.military_force	base.militaryinfiction.military_rank_in_fiction	base.militaryinfiction.armed_force_in_fiction
base.militaryinfiction.military_character_service.rank/base.militaryinfiction.military_character_service.unit	base.militaryinfiction.military_rank_in_fiction	base.militaryinfiction.military_unit_in_fiction
base.militaryinfiction.military_character_service.rank/base.militaryinfiction.military_character_service.work_of_fiction	base.militaryinfiction.military_rank_in_fiction	fictional_universe.work_of_fiction
base.militaryinfiction.military_character_service.unit/base.militaryinfiction.military_character_service.military_character	base.militaryinfiction.military_unit_in_fiction	base.militaryinfiction.military_character
base.militaryinfiction.military_character_service.unit/base.militaryinfiction.military_character_service.military_force	base.militaryinfiction.military_unit_in_fiction	base.militaryinfiction.armed_force_in_fiction
base.militaryinfiction.military_character_service.unit/base.militaryinfiction.military_character_service.work_of_fiction	base.militaryinfiction.military_unit_in_fiction	fictional_universe.work_of_fiction
base.militaryinfiction.military_character_service.work_of_fiction/base.militaryinfiction.military_character_service.military_character	fictional_universe.work_of_fiction	base.militaryinfiction.military_character
base.militaryinfiction.military_character_service.work_of_fiction/base.militaryinfiction.military_character_service.military_force	fictional_universe.work_of_fiction	base.militaryinfiction.armed_force_in_fiction
base.militaryinfiction.military_combatant_group_tenure_in_fiction.ally/base.militaryinfiction.military_combatant_group_tenure_in_fiction.military_alliance	base.militaryinfiction.military_combatant_in_fiction	base.militaryinfiction.military_combatant_in_fiction
base.militaryinfiction.military_combatant_group_tenure_in_fiction.ally/base.militaryinfiction.military_combatant_group_tenure_in_fiction.work_of_fiction	base.militaryinfiction.military_combatant_in_fiction	fictional_universe.work_of_fiction
base.militaryinfiction.military_combatant_group_tenure_in_fiction.work_of_fiction/base.militaryinfiction.military_combatant_group_tenure_in_fiction.military_alliance	fictional_universe.work_of_fiction	base.militaryinfiction.military_combatant_in_fiction
base.militaryinfiction.military_command_in_fiction.military_combatant/base.militaryinfiction.military_command_in_fiction.mentioned_in_works	base.militaryinfiction.military_combatant_in_fiction	fictional_universe.work_of_fiction
base.militaryinfiction.military_command_in_fiction.military_commander/base.militaryinfiction.military_command_in_fiction.mentioned_in_works	base.militaryinfiction.military_commander_in_fiction	fictional_universe.work_of_fiction
base.militaryinfiction.military_command_in_fiction.military_commander/base.militaryinfiction.military_command_in_fiction.military_combatant	base.militaryinfiction.military_commander_in_fiction	base.militaryinfiction.military_combatant_in_fiction
base.militaryinfiction.military_command_in_fiction.military_commander/base.militaryinfiction.military_command_in_fiction.military_conflict	base.militaryinfiction.military_commander_in_fiction	base.militaryinfiction.military_conflict_in_fiction
base.militaryinfiction.military_command_in_fiction.military_commander/base.militaryinfiction.military_command_in_fiction.unit	base.militaryinfiction.military_commander_in_fiction	base.militaryinfiction.military_unit_in_fiction
base.militaryinfiction.military_command_in_fiction.military_conflict/base.militaryinfiction.military_command_in_fiction.mentioned_in_works	base.militaryinfiction.military_conflict_in_fiction	fictional_universe.work_of_fiction
base.militaryinfiction.military_command_in_fiction.military_conflict/base.militaryinfiction.military_command_in_fiction.military_combatant	base.militaryinfiction.military_conflict_in_fiction	base.militaryinfiction.military_combatant_in_fiction
base.militaryinfiction.military_command_in_fiction.military_conflict/base.militaryinfiction.military_command_in_fiction.unit	base.militaryinfiction.military_conflict_in_fiction	base.militaryinfiction.military_unit_in_fiction
base.militaryinfiction.military_command_in_fiction.unit/base.militaryinfiction.military_command_in_fiction.mentioned_in_works	base.militaryinfiction.military_unit_in_fiction	fictional_universe.work_of_fiction
base.militaryinfiction.military_command_in_fiction.unit/base.militaryinfiction.military_command_in_fiction.military_combatant	base.militaryinfiction.military_unit_in_fiction	base.militaryinfiction.military_combatant_in_fiction
base.partnersinflight.population_estimate.location/base.partnersinflight.population_estimate.source	base.litcentral.focal_location	base.partnersinflight.population_estimate_source
base.partnersinflight.population_estimate.location/base.partnersinflight.population_estimate.species	base.litcentral.focal_location	base.birdconservation.bird_taxa
base.partnersinflight.population_estimate.species/base.partnersinflight.population_estimate.source	base.birdconservation.bird_taxa	base.partnersinflight.population_estimate_source
base.politicalconventions.convention_leadership.convention/base.politicalconventions.convention_leadership.leader	base.politicalconventions.political_convention	base.politicalconventions.convention_leader
base.politicalconventions.convention_leadership.title/base.politicalconventions.convention_leadership.convention	business.job_title	base.politicalconventions.political_convention
base.politicalconventions.convention_leadership.title/base.politicalconventions.convention_leadership.leader	business.job_title	base.politicalconventions.convention_leader
base.popstra.arrest.location/base.popstra.arrest.arrested_person	base.popstra.location	base.popstra.celebrity
base.popstra.arrest.location/base.popstra.arrest.offense	base.popstra.location	base.popstra.criminal_offense
base.popstra.arrest.offense/base.popstra.arrest.arrested_person	base.popstra.criminal_offense	base.popstra.celebrity
base.popstra.infidelity.participant/base.popstra.infidelity.victim	base.popstra.celebrity	base.popstra.celebrity
base.popstra.infidelity.perpetrator/base.popstra.infidelity.participant	base.popstra.celebrity	base.popstra.celebrity
base.popstra.infidelity.perpetrator/base.popstra.infidelity.victim	base.popstra.celebrity	base.popstra.celebrity
base.saturdaynightlive.snl_movie_spin_off_cast_performance.snl_cast_member/base.saturdaynightlive.snl_movie_spin_off_cast_performance.character	base.saturdaynightlive.snl_cast_member	base.saturdaynightlive.snl_character
base.saturdaynightlive.snl_movie_spin_off_cast_performance.snl_cast_member/base.saturdaynightlive.snl_movie_spin_off_cast_performance.snl_movie_spin_off	base.saturdaynightlive.snl_cast_member	base.saturdaynightlive.snl_movie_spin_off
base.saturdaynightlive.snl_movie_spin_off_cast_performance.snl_movie_spin_off/base.saturdaynightlive.snl_movie_spin_off_cast_performance.character	base.saturdaynightlive.snl_movie_spin_off	base.saturdaynightlive.snl_character
base.schemastaging.athlete_salary.currency/base.schemastaging.athlete_salary.athlete	finance.currency	base.schemastaging.athlete_extra
base.schemastaging.athlete_salary.team/base.schemastaging.athlete_salary.athlete	base.schemastaging.sports_team_extra	base.schemastaging.athlete_extra
base.schemastaging.athlete_salary.team/base.schemastaging.athlete_salary.currency	base.schemastaging.sports_team_extra	finance.currency
base.schemastaging.phone_sandbox.product_or_service/base.schemastaging.phone_sandbox.caller_category	base.schemastaging.contact_product	base.schemastaging.contactor_category
base.schemastaging.phone_sandbox.product_or_service/base.schemastaging.phone_sandbox.service_location	base.schemastaging.contact_product	location.location
base.schemastaging.phone_sandbox.service_language/base.schemastaging.phone_sandbox.caller_category	language.human_language	base.schemastaging.contactor_category
base.schemastaging.phone_sandbox.service_language/base.schemastaging.phone_sandbox.product_or_service	language.human_language	base.schemastaging.contact_product
base.schemastaging.phone_sandbox.service_language/base.schemastaging.phone_sandbox.service_location	language.human_language	location.location
base.schemastaging.phone_sandbox.service_location/base.schemastaging.phone_sandbox.caller_category	location.location	base.schemastaging.contactor_category
base.schemastaging.tv_star_dubbing_performance.character/base.schemastaging.tv_star_dubbing_performance.actor	base.schemastaging.tv_character_extra	base.schemastaging.tv_actor_extra
base.schemastaging.tv_star_dubbing_performance.character/base.schemastaging.tv_star_dubbing_performance.program	base.schemastaging.tv_character_extra	base.schemastaging.tv_program_extra
base.schemastaging.tv_star_dubbing_performance.language/base.schemastaging.tv_star_dubbing_performance.actor	language.human_language	base.schemastaging.tv_actor_extra
base.schemastaging.tv_star_dubbing_performance.language/base.schemastaging.tv_star_dubbing_performance.character	language.human_language	base.schemastaging.tv_character_extra
base.schemastaging.tv_star_dubbing_performance.language/base.schemastaging.tv_star_dubbing_performance.program	language.human_language	base.schemastaging.tv_program_extra
base.schemastaging.tv_star_dubbing_performance.program/base.schemastaging.tv_star_dubbing_performance.actor	base.schemastaging.tv_program_extra	base.schemastaging.tv_actor_extra
base.sharing.sharing_relationship.locations/base.sharing.sharing_relationship.method	base.sharing.sharing_location	base.sharing.sharing_method
base.sharing.sharing_relationship.shares/base.sharing.sharing_relationship.locations	base.sharing.sharable_thing	base.sharing.sharing_location
base.sharing.sharing_relationship.shares/base.sharing.sharing_relationship.method	base.sharing.sharable_thing	base.sharing.sharing_method
base.siswimsuitmodels.si_swimsuit_appearance.model/base.siswimsuitmodels.si_swimsuit_appearance.shooting_locations	base.siswimsuitmodels.si_swimsuit_model	location.location
base.siswimsuitmodels.si_swimsuit_appearance.model/base.siswimsuitmodels.si_swimsuit_appearance.year	base.siswimsuitmodels.si_swimsuit_model	book.magazine_issue
base.siswimsuitmodels.si_swimsuit_appearance.year/base.siswimsuitmodels.si_swimsuit_appearance.shooting_locations	book.magazine_issue	location.location
base.survivor.survivor_tribe_membership.contestant/base.survivor.survivor_tribe_membership.tribe	base.survivor.survivor_contestant	base.survivor.survivor_tribe
base.survivor.survivor_tribe_membership.episode_ended/base.survivor.survivor_tribe_membership.contestant	base.survivor.survivor_episode	base.survivor.survivor_contestant
base.survivor.survivor_tribe_membership.episode_ended/base.survivor.survivor_tribe_membership.tribe	base.survivor.survivor_episode	base.survivor.survivor_tribe
base.survivor.survivor_tribe_membership.episode_started/base.survivor.survivor_tribe_membership.contestant	base.survivor.survivor_episode	base.survivor.survivor_contestant
base.survivor.survivor_tribe_membership.episode_started/base.survivor.survivor_tribe_membership.episode_ended	base.survivor.survivor_episode	base.survivor.survivor_episode
base.survivor.survivor_tribe_membership.episode_started/base.survivor.survivor_tribe_membership.tribe	base.survivor.survivor_episode	base.survivor.survivor_tribe
base.theosbornboysaregrowing.trip.activities_undertaken/base.theosbornboysaregrowing.trip.mode_of_transport	travel.tourist_attraction	travel.transportation_mode
base.theosbornboysaregrowing.trip.activities_undertaken/base.theosbornboysaregrowing.trip.people_visited	travel.tourist_attraction	people.person
base.theosbornboysaregrowing.trip.activities_undertaken/base.theosbornboysaregrowing.trip.travelers	travel.tourist_attraction	base.theosbornboysaregrowing.osborn_family_member
base.theosbornboysaregrowing.trip.destination/base.theosbornboysaregrowing.trip.activities_undertaken	location.location	travel.tourist_attraction
base.theosbornboysaregrowing.trip.destination/base.theosbornboysaregrowing.trip.mode_of_transport	location.location	travel.transportation_mode
base.theosbornboysaregrowing.trip.destination/base.theosbornboysaregrowing.trip.people_visited	location.location	people.person
base.theosbornboysaregrowing.trip.destination/base.theosbornboysaregrowing.trip.travelers	location.location	base.theosbornboysaregrowing.osborn_family_member
base.theosbornboysaregrowing.trip.mode_of_transport/base.theosbornboysaregrowing.trip.people_visited	travel.transportation_mode	people.person
base.theosbornboysaregrowing.trip.mode_of_transport/base.theosbornboysaregrowing.trip.travelers	travel.transportation_mode	base.theosbornboysaregrowing.osborn_family_member
base.theosbornboysaregrowing.trip.travelers/base.theosbornboysaregrowing.trip.people_visited	base.theosbornboysaregrowing.osborn_family_member	people.person
base.tournaments.group_competitor_relationship.competitor/base.tournaments.group_competitor_relationship.advanced_to	base.tournaments.tournament_competitor	base.tournaments.tournament_round
base.tournaments.group_competitor_relationship.competitor/base.tournaments.group_competitor_relationship.group	base.tournaments.tournament_competitor	base.tournaments.tournament_group
base.tournaments.group_competitor_relationship.group/base.tournaments.group_competitor_relationship.advanced_to	base.tournaments.tournament_group	base.tournaments.tournament_round
base.umltools.code_generation.programming_language/base.umltools.code_generation.diagram_types	computer.programming_language	base.umltools.uml_diagram_type
base.umltools.code_generation.programming_language/base.umltools.code_generation.uml_tool	computer.programming_language	base.umltools.uml_tool
base.umltools.code_generation.uml_tool/base.umltools.code_generation.diagram_types	base.umltools.uml_tool	base.umltools.uml_diagram_type
base.umltools.round_trip_engineering.programming_language/base.umltools.round_trip_engineering.uml_tool	computer.programming_language	base.umltools.uml_tool
base.umltools.round_trip_engineering.rt_type/base.umltools.round_trip_engineering.programming_language	base.umltools.round_trip_engineering_support	computer.programming_language
base.umltools.round_trip_engineering.rt_type/base.umltools.round_trip_engineering.uml_tool	base.umltools.round_trip_engineering_support	base.umltools.uml_tool
base.vgames.video_game_release.region/base.vgames.video_game_release.platform	location.location	cvg.cvg_platform
base.vgames.video_game_release.video_game/base.vgames.video_game_release.platform	base.vgames.video_game	cvg.cvg_platform
base.vgames.video_game_release.video_game/base.vgames.video_game_release.region	base.vgames.video_game	location.location
base.visleg.collaborative_participation.collaboration/base.visleg.collaborative_participation.collaborator	base.visleg.collaboration	base.visleg.collaborator
base.visleg.collaborative_participation.collaboration/base.visleg.collaborative_participation.role	base.visleg.collaboration	base.visleg.collaborator_role
base.visleg.collaborative_participation.role/base.visleg.collaborative_participation.collaborator	base.visleg.collaborator_role	base.visleg.collaborator
base.vwmtbase.vw_adapter_2_data_representation.to_data_representation/base.vwmtbase.vw_adapter_2_data_representation.from_adapter	base.vwmtbase.vw_data_representation	base.vwmtbase.vw_adapter
base.vwmtbase.vw_adapter_2_data_representation.vw/base.vwmtbase.vw_adapter_2_data_representation.from_adapter	base.vwmtbase.visual_wiki	base.vwmtbase.vw_adapter
base.vwmtbase.vw_adapter_2_data_representation.vw/base.vwmtbase.vw_adapter_2_data_representation.to_data_representation	base.vwmtbase.visual_wiki	base.vwmtbase.vw_data_representation
base.vwmtbase.vw_adapter_2_tranformation_agent.from_adapter/base.vwmtbase.vw_adapter_2_tranformation_agent.to_transformation_agent	base.vwmtbase.vw_adapter	base.vwmtbase.vw_transformation_agent
base.vwmtbase.vw_adapter_2_tranformation_agent.from_adapter/base.vwmtbase.vw_adapter_2_tranformation_agent.vw	base.vwmtbase.vw_adapter	base.vwmtbase.visual_wiki
base.vwmtbase.vw_adapter_2_tranformation_agent.vw/base.vwmtbase.vw_adapter_2_tranformation_agent.to_transformation_agent	base.vwmtbase.visual_wiki	base.vwmtbase.vw_transformation_agent
base.vwmtbase.vw_data_representation_2_transformation_agent.from_data_representation/base.vwmtbase.vw_data_representation_2_transformation_agent.to_transformation_agent	base.vwmtbase.vw_data_representation	base.vwmtbase.vw_transformation_agent
base.vwmtbase.vw_data_representation_2_transformation_agent.from_data_representation/base.vwmtbase.vw_data_representation_2_transformation_agent.vw	base.vwmtbase.vw_data_representation	base.vwmtbase.visual_wiki
base.vwmtbase.vw_data_representation_2_transformation_agent.to_transformation_agent/base.vwmtbase.vw_data_representation_2_transformation_agent.vw	base.vwmtbase.vw_transformation_agent	base.vwmtbase.visual_wiki
base.vwmtbase.vw_data_source_2_adapter.from_data_source/base.vwmtbase.vw_data_source_2_adapter.vw	base.vwmtbase.data_source	base.vwmtbase.visual_wiki
base.vwmtbase.vw_data_source_2_adapter.to_adapter/base.vwmtbase.vw_data_source_2_adapter.from_data_source	base.vwmtbase.vw_adapter	base.vwmtbase.data_source
base.vwmtbase.vw_data_source_2_adapter.to_adapter/base.vwmtbase.vw_data_source_2_adapter.vw	base.vwmtbase.vw_adapter	base.vwmtbase.visual_wiki
base.vwmtbase.vw_transformation_agent_2_data_representation.from_transformation_agent/base.vwmtbase.vw_transformation_agent_2_data_representation.vw	base.vwmtbase.vw_transformation_agent	base.vwmtbase.visual_wiki
base.vwmtbase.vw_transformation_agent_2_data_representation.to_data_representation/base.vwmtbase.vw_transformation_agent_2_data_representation.from_transformation_agent	base.vwmtbase.vw_data_representation	base.vwmtbase.vw_transformation_agent
base.vwmtbase.vw_transformation_agent_2_data_representation.to_data_representation/base.vwmtbase.vw_transformation_agent_2_data_representation.vw	base.vwmtbase.vw_data_representation	base.vwmtbase.visual_wiki
base.webvideo.internet_video_crew_gig.role/base.webvideo.internet_video_crew_gig.crewmember	base.webvideo.internet_video_crew_role	base.webvideo.internet_video_crewmember
base.webvideo.internet_video_crew_gig.video/base.webvideo.internet_video_crew_gig.crewmember	base.webvideo.internet_video	base.webvideo.internet_video_crewmember
base.webvideo.internet_video_crew_gig.video/base.webvideo.internet_video_crew_gig.role	base.webvideo.internet_video	base.webvideo.internet_video_crew_role
base.webvideo.internet_video_performance.actor/base.webvideo.internet_video_performance.character	base.webvideo.internet_video_actor	base.webvideo.internet_video_character
base.webvideo.internet_video_performance.actor/base.webvideo.internet_video_performance.video	base.webvideo.internet_video_actor	base.webvideo.internet_video
base.webvideo.internet_video_performance.character/base.webvideo.internet_video_performance.video	base.webvideo.internet_video_character	base.webvideo.internet_video
base.webvideo.internet_video_regular_performance.actor/base.webvideo.internet_video_regular_performance.character	base.webvideo.internet_video_actor	base.webvideo.internet_video_character
base.webvideo.internet_video_regular_performance.actor/base.webvideo.internet_video_regular_performance.series	base.webvideo.internet_video_actor	base.webvideo.internet_video_series
base.webvideo.internet_video_regular_performance.series/base.webvideo.internet_video_regular_performance.character	base.webvideo.internet_video_series	base.webvideo.internet_video_character
base.webvideo.internet_video_series_crew_gig.crewmember/base.webvideo.internet_video_series_crew_gig.role	base.webvideo.internet_video_crewmember	base.webvideo.internet_video_crew_role
base.webvideo.internet_video_series_crew_gig.crewmember/base.webvideo.internet_video_series_crew_gig.series	base.webvideo.internet_video_crewmember	base.webvideo.internet_video_series
base.webvideo.internet_video_series_crew_gig.role/base.webvideo.internet_video_series_crew_gig.series	base.webvideo.internet_video_crew_role	base.webvideo.internet_video_series
base.x2010fifaworldcupsouthafrica.current_world_cup_squad.current_club/base.x2010fifaworldcupsouthafrica.current_world_cup_squad.national_team	soccer.football_team	base.x2010fifaworldcupsouthafrica.world_cup_squad
base.x2010fifaworldcupsouthafrica.current_world_cup_squad.players/base.x2010fifaworldcupsouthafrica.current_world_cup_squad.current_club	base.x2010fifaworldcupsouthafrica.world_cup_participant	soccer.football_team
base.x2010fifaworldcupsouthafrica.current_world_cup_squad.players/base.x2010fifaworldcupsouthafrica.current_world_cup_squad.national_team	base.x2010fifaworldcupsouthafrica.world_cup_participant	base.x2010fifaworldcupsouthafrica.world_cup_squad
base.x2010fifaworldcupsouthafrica.current_world_cup_squad.position/base.x2010fifaworldcupsouthafrica.current_world_cup_squad.current_club	soccer.football_position	soccer.football_team
base.x2010fifaworldcupsouthafrica.current_world_cup_squad.position/base.x2010fifaworldcupsouthafrica.current_world_cup_squad.national_team	soccer.football_position	base.x2010fifaworldcupsouthafrica.world_cup_squad
base.x2010fifaworldcupsouthafrica.current_world_cup_squad.position/base.x2010fifaworldcupsouthafrica.current_world_cup_squad.players	soccer.football_position	base.x2010fifaworldcupsouthafrica.world_cup_participant
base.x2010fifaworldcupsouthafrica.host_cities.venue/base.x2010fifaworldcupsouthafrica.host_cities.cities	sports.sports_facility	location.location
base.x2010fifaworldcupsouthafrica.host_cities.venue/base.x2010fifaworldcupsouthafrica.host_cities.world_cup_event	sports.sports_facility	base.x2010fifaworldcupsouthafrica.fifa_world_cup
base.x2010fifaworldcupsouthafrica.host_cities.world_cup_event/base.x2010fifaworldcupsouthafrica.host_cities.cities	base.x2010fifaworldcupsouthafrica.fifa_world_cup	location.location
base.x2010fifaworldcupsouthafrica.world_cup_qualifying_team.qualifying_group/base.x2010fifaworldcupsouthafrica.world_cup_qualifying_team.national_team	base.x2010fifaworldcupsouthafrica.world_cup_qualification_group	base.x2010fifaworldcupsouthafrica.world_cup_participation
base.x2010fifaworldcupsouthafrica.world_cup_qualifying_team.qualifying_group/base.x2010fifaworldcupsouthafrica.world_cup_qualifying_team.world_cup_qualification	base.x2010fifaworldcupsouthafrica.world_cup_qualification_group	base.x2010fifaworldcupsouthafrica.world_cup_qualification
base.x2010fifaworldcupsouthafrica.world_cup_qualifying_team.world_cup_qualification/base.x2010fifaworldcupsouthafrica.world_cup_qualifying_team.national_team	base.x2010fifaworldcupsouthafrica.world_cup_qualification	base.x2010fifaworldcupsouthafrica.world_cup_participation
base.x2010fifaworldcupsouthafrica.world_cup_team.national_team/base.x2010fifaworldcupsouthafrica.world_cup_team.qualification_group	base.x2010fifaworldcupsouthafrica.world_cup_participation	base.x2010fifaworldcupsouthafrica.world_cup_qualification_group
base.x2010fifaworldcupsouthafrica.world_cup_team.world_cup/base.x2010fifaworldcupsouthafrica.world_cup_team.national_team	base.x2010fifaworldcupsouthafrica.fifa_world_cup	base.x2010fifaworldcupsouthafrica.world_cup_participation
base.x2010fifaworldcupsouthafrica.world_cup_team.world_cup/base.x2010fifaworldcupsouthafrica.world_cup_team.qualification_group	base.x2010fifaworldcupsouthafrica.fifa_world_cup	base.x2010fifaworldcupsouthafrica.world_cup_qualification_group
basketball.basketball_player_stats.player/basketball.basketball_player_stats.team	basketball.basketball_player	basketball.basketball_team
basketball.basketball_player_stats.season/basketball.basketball_player_stats.player	sports.sports_league_season	basketball.basketball_player
basketball.basketball_player_stats.season/basketball.basketball_player_stats.team	sports.sports_league_season	basketball.basketball_team
biology.breed_registration.breed/biology.breed_registration.breed_group	biology.animal_breed	biology.breed_group
biology.breed_registration.breed/biology.breed_registration.registry	biology.animal_breed	biology.breed_registry
biology.breed_registration.registry/biology.breed_registration.breed_group	biology.breed_registry	biology.breed_group
biology.organism_classification_placement.higher_classification/biology.organism_classification_placement.lower_classification	biology.organism_classification	biology.organism_classification
biology.organism_classification_placement.higher_classification/biology.organism_classification_placement.taxonomic_authority	biology.organism_classification	biology.taxonomic_authority
biology.organism_classification_placement.lower_classification/biology.organism_classification_placement.taxonomic_authority	biology.organism_classification	biology.taxonomic_authority
book.editorial_tenure.periodical/book.editorial_tenure.editor	book.periodical	book.periodical_editor
book.editorial_tenure.title/book.editorial_tenure.editor	book.editor_title	book.periodical_editor
book.editorial_tenure.title/book.editorial_tenure.periodical	book.editor_title	book.periodical
business.competitive_space_mediator.brand/business.competitive_space_mediator.company	business.brand	business.business_operation
business.competitive_space_mediator.brand/business.competitive_space_mediator.space	business.brand	business.competitive_space
business.competitive_space_mediator.company/business.competitive_space_mediator.space	business.business_operation	business.competitive_space
business.market_share.company/business.market_share.region	business.business_operation	location.location
business.market_share.company/business.market_share.space	business.business_operation	business.competitive_space
business.market_share.space/business.market_share.region	business.competitive_space	location.location
business.open_times.time_zone/business.open_times.weekday_start	time.time_zone	time.day_of_week
business.open_times.weekday_end/business.open_times.time_zone	time.day_of_week	time.time_zone
business.open_times.weekday_end/business.open_times.weekday_start	time.day_of_week	time.day_of_week
business.product_endorsement.endorser/business.product_endorsement.endorsee	business.product_endorser	business.product_endorsee
business.product_endorsement.product/business.product_endorsement.endorsee	business.endorsed_product	business.product_endorsee
business.product_endorsement.product/business.product_endorsement.endorser	business.endorsed_product	business.product_endorser
cricket.cricket_roster_batting.bowled/cricket.cricket_roster_batting.dismissal_type	cricket.cricket_bowler	cricket.dismissal_type
cricket.cricket_roster_batting.bowled/cricket.cricket_roster_batting.player	cricket.cricket_bowler	cricket.cricket_player
cricket.cricket_roster_batting.bowled/cricket.cricket_roster_batting.roster	cricket.cricket_bowler	cricket.cricket_roster
cricket.cricket_roster_batting.dismissed_by/cricket.cricket_roster_batting.bowled	cricket.cricket_player	cricket.cricket_bowler
cricket.cricket_roster_batting.dismissed_by/cricket.cricket_roster_batting.dismissal_type	cricket.cricket_player	cricket.dismissal_type
cricket.cricket_roster_batting.dismissed_by/cricket.cricket_roster_batting.player	cricket.cricket_player	cricket.cricket_player
cricket.cricket_roster_batting.dismissed_by/cricket.cricket_roster_batting.roster	cricket.cricket_player	cricket.cricket_roster
cricket.cricket_roster_batting.player/cricket.cricket_roster_batting.dismissal_type	cricket.cricket_player	cricket.dismissal_type
cricket.cricket_roster_batting.player/cricket.cricket_roster_batting.roster	cricket.cricket_player	cricket.cricket_roster
cricket.cricket_roster_batting.roster/cricket.cricket_roster_batting.dismissal_type	cricket.cricket_roster	cricket.dismissal_type
cvg.game_performance.character/cvg.game_performance.voice_actor	cvg.game_character	cvg.game_voice_actor
cvg.game_performance.game/cvg.game_performance.character	cvg.computer_videogame	cvg.game_character
cvg.game_performance.game/cvg.game_performance.voice_actor	cvg.computer_videogame	cvg.game_voice_actor
cvg.musical_game_song_relationship.platforms/cvg.musical_game_song_relationship.game	cvg.cvg_platform	cvg.musical_game
cvg.musical_game_song_relationship.song/cvg.musical_game_song_relationship.game	cvg.musical_game_song	cvg.musical_game
cvg.musical_game_song_relationship.song/cvg.musical_game_song_relationship.platforms	cvg.musical_game_song	cvg.cvg_platform
education.education.degree/education.education.institution	education.educational_degree	education.educational_institution
education.education.degree/education.education.major_field_of_study	education.educational_degree	education.field_of_study
education.education.degree/education.education.minor	education.educational_degree	education.field_of_study
education.education.degree/education.education.specialization	education.educational_degree	education.field_of_study
education.education.degree/education.education.student	education.educational_degree	people.person
education.education.institution/education.education.major_field_of_study	education.educational_institution	education.field_of_study
education.education.institution/education.education.minor	education.educational_institution	education.field_of_study
education.education.institution/education.education.specialization	education.educational_institution	education.field_of_study
education.education.institution/education.education.student	education.educational_institution	people.person
education.education.major_field_of_study/education.education.minor	education.field_of_study	education.field_of_study
education.education.major_field_of_study/education.education.student	education.field_of_study	people.person
education.education.specialization/education.education.major_field_of_study	education.field_of_study	education.field_of_study
education.education.specialization/education.education.minor	education.field_of_study	education.field_of_study
education.education.specialization/education.education.student	education.field_of_study	people.person
education.education.student/education.education.minor	people.person	education.field_of_study
education.honorary_degree.degree/education.honorary_degree.institution	education.educational_degree	education.educational_institution
education.honorary_degree.recipient/education.honorary_degree.degree	education.honorary_degree_recipient	education.educational_degree
education.honorary_degree.recipient/education.honorary_degree.institution	education.honorary_degree_recipient	education.educational_institution
fashion.clothing_size.article_of_clothing/fashion.clothing_size.person	fashion.garment	people.measured_person
fashion.clothing_size.article_of_clothing/fashion.clothing_size.region	fashion.garment	location.location
fashion.clothing_size.person/fashion.clothing_size.region	people.measured_person	location.location
fictional_universe.fictional_employment_tenure.employee/fictional_universe.fictional_employment_tenure.employer	fictional_universe.fictional_character	fictional_universe.fictional_employer
fictional_universe.fictional_employment_tenure.title/fictional_universe.fictional_employment_tenure.employee	fictional_universe.fictional_job_title	fictional_universe.fictional_character
fictional_universe.fictional_employment_tenure.title/fictional_universe.fictional_employment_tenure.employer	fictional_universe.fictional_job_title	fictional_universe.fictional_employer
film.dubbing_performance.character/film.dubbing_performance.actor	film.film_character	film.actor
film.dubbing_performance.character/film.dubbing_performance.film	film.film_character	film.film
film.dubbing_performance.film/film.dubbing_performance.actor	film.film	film.actor
film.dubbing_performance.language/film.dubbing_performance.actor	language.human_language	film.actor
film.dubbing_performance.language/film.dubbing_performance.character	language.human_language	film.film_character
film.dubbing_performance.language/film.dubbing_performance.film	language.human_language	film.film
film.film_crew_gig.crewmember/film.film_crew_gig.film	film.film_crewmember	film.film
film.film_crew_gig.crewmember/film.film_crew_gig.film_crew_role	film.film_crewmember	film.film_job
film.film_crew_gig.film/film.film_crew_gig.film_crew_role	film.film	film.film_job
film.film_film_company_relationship.film_company/film.film_film_company_relationship.film	film.film_company	film.film
film.film_film_company_relationship.film_company/film.film_film_company_relationship.role_service	film.film_company	film.film_company_role_or_service
film.film_film_company_relationship.film/film.film_film_company_relationship.role_service	film.film	film.film_company_role_or_service
film.film_film_distributor_relationship.distributor/film.film_film_distributor_relationship.film	film.film_distributor	film.film
film.film_film_distributor_relationship.distributor/film.film_film_distributor_relationship.region	film.film_distributor	location.location
film.film_film_distributor_relationship.film/film.film_film_distributor_relationship.region	film.film	location.location
film.performance.character/film.performance.actor	film.film_character	film.actor
film.performance.character/film.performance.film	film.film_character	film.film
film.performance.film/film.performance.actor	film.film	film.actor
food.recipe_ingredient.ingredient/food.recipe_ingredient.recipe	food.ingredient	food.recipe
food.recipe_ingredient.ingredient/food.recipe_ingredient.unit	food.ingredient	food.culinary_measure
food.recipe_ingredient.recipe/food.recipe_ingredient.unit	food.recipe	food.culinary_measure
government.government_position_held.appointed_by/government.government_position_held.jurisdiction_of_office	government.political_appointer	government.governmental_jurisdiction
government.government_position_held.appointed_by/government.government_position_held.legislative_sessions	government.political_appointer	government.legislative_session
government.government_position_held.district_represented/government.government_position_held.appointed_by	government.political_district	government.political_appointer
government.government_position_held.district_represented/government.government_position_held.governmental_body	government.political_district	government.governmental_body
government.government_position_held.district_represented/government.government_position_held.jurisdiction_of_office	government.political_district	government.governmental_jurisdiction
government.government_position_held.district_represented/government.government_position_held.legislative_sessions	government.political_district	government.legislative_session
government.government_position_held.governmental_body/government.government_position_held.appointed_by	government.governmental_body	government.political_appointer
government.government_position_held.governmental_body/government.government_position_held.jurisdiction_of_office	government.governmental_body	government.governmental_jurisdiction
government.government_position_held.governmental_body/government.government_position_held.legislative_sessions	government.governmental_body	government.legislative_session
government.government_position_held.legislative_sessions/government.government_position_held.jurisdiction_of_office	government.legislative_session	government.governmental_jurisdiction
interests.collection.category/interests.collection.collector	interests.collection_category	interests.collector
interests.collection.items/interests.collection.category	interests.collectable_item	interests.collection_category
interests.collection.items/interests.collection.collector	interests.collectable_item	interests.collector
law.judicial_tenure.court/law.judicial_tenure.judge	law.court	law.judge
law.judicial_tenure.court/law.judicial_tenure.title	law.court	law.judicial_title
law.judicial_tenure.judge/law.judicial_tenure.title	law.judge	law.judicial_title
law.legal_case_party_relationship.case/law.legal_case_party_relationship.parties	law.legal_case	law.litigant
law.legal_case_party_relationship.role/law.legal_case_party_relationship.case	law.legal_party_role	law.legal_case
law.legal_case_party_relationship.role/law.legal_case_party_relationship.parties	law.legal_party_role	law.litigant
location.mailing_address.country/location.mailing_address.citytown	location.country	location.location
location.mailing_address.country/location.mailing_address.postal_code	location.country	location.postal_code
location.mailing_address.country/location.mailing_address.state_province_region	location.country	location.administrative_division
location.mailing_address.postal_code/location.mailing_address.citytown	location.postal_code	location.location
location.mailing_address.state_province_region/location.mailing_address.citytown	location.administrative_division	location.location
location.mailing_address.state_province_region/location.mailing_address.postal_code	location.administrative_division	location.postal_code
media_common.dedication.dedicated_by/media_common.dedication.dedicated_to	media_common.dedicator	media_common.dedicatee
media_common.dedication.dedicated_by/media_common.dedication.work_dedicated	media_common.dedicator	media_common.dedicated_work
media_common.dedication.dedicated_to/media_common.dedication.work_dedicated	media_common.dedicatee	media_common.dedicated_work
military.force_strength.combatant/military.force_strength.military_conflict	military.military_combatant	military.military_conflict
military.force_strength.resource/military.force_strength.combatant	military.military_resource	military.military_combatant
military.force_strength.resource/military.force_strength.military_conflict	military.military_resource	military.military_conflict
military.military_command.military_combatant/military.military_command.military_commander	military.military_combatant	military.military_commander
military.military_command.military_combatant/military.military_command.military_conflict	military.military_combatant	military.military_conflict
military.military_command.military_conflict/military.military_command.military_commander	military.military_conflict	military.military_commander
military.military_service.military_force/military.military_service.unit	military.armed_force	military.military_unit
military.military_service.military_person/military.military_service.military_force	military.military_person	military.armed_force
military.military_service.military_person/military.military_service.rank	military.military_person	military.rank
military.military_service.military_person/military.military_service.unit	military.military_person	military.military_unit
military.military_service.rank/military.military_service.military_force	military.rank	military.armed_force
military.military_service.rank/military.military_service.unit	military.rank	military.military_unit
music.concert_performance.band_members/music.concert_performance.artist	music.artist	music.artist
music.concert_performance.band_members/music.concert_performance.concert	music.artist	music.concert
music.concert_performance.concert/music.concert_performance.artist	music.concert	music.artist
music.group_membership.member/music.group_membership.group	music.group_member	music.musical_group
music.group_membership.role/music.group_membership.group	music.performance_role	music.musical_group
music.group_membership.role/music.group_membership.member	music.performance_role	music.group_member
music.recording_contribution.contributor/music.recording_contribution.album	music.artist	music.album
music.recording_contribution.contributor/music.recording_contribution.performance_role	music.artist	music.performance_role
music.recording_contribution.performance_role/music.recording_contribution.album	music.performance_role	music.album
olympics.olympic_athlete_affiliation.athlete/olympics.olympic_athlete_affiliation.olympics	olympics.olympic_athlete	olympics.olympic_games
olympics.olympic_athlete_affiliation.country/olympics.olympic_athlete_affiliation.athlete	olympics.olympic_participating_country	olympics.olympic_athlete
olympics.olympic_athlete_affiliation.country/olympics.olympic_athlete_affiliation.olympics	olympics.olympic_participating_country	olympics.olympic_games
olympics.olympic_medal_honor.country/olympics.olympic_medal_honor.event	olympics.olympic_participating_country	olympics.olympic_event_competition
olympics.olympic_medal_honor.country/olympics.olympic_medal_honor.medalist	olympics.olympic_participating_country	olympics.olympic_athlete
olympics.olympic_medal_honor.medalist/olympics.olympic_medal_honor.event	olympics.olympic_athlete	olympics.olympic_event_competition
olympics.olympic_medal_honor.olympics/olympics.olympic_medal_honor.country	olympics.olympic_games	olympics.olympic_participating_country
olympics.olympic_medal_honor.olympics/olympics.olympic_medal_honor.event	olympics.olympic_games	olympics.olympic_event_competition
olympics.olympic_medal_honor.olympics/olympics.olympic_medal_honor.medalist	olympics.olympic_games	olympics.olympic_athlete
olympics.olympic_torch_relay.olympics/olympics.olympic_torch_relay.location	olympics.olympic_games	olympics.olympic_torch_relay_location
olympics.olympic_torch_relay.torchbearer/olympics.olympic_torch_relay.location	olympics.olympic_torchbearer	olympics.olympic_torch_relay_location
olympics.olympic_torch_relay.torchbearer/olympics.olympic_torch_relay.olympics	olympics.olympic_torchbearer	olympics.olympic_games
opera.opera_designer_gig.design_role/opera.opera_designer_gig.designer	opera.opera_designer_role	opera.opera_designer
opera.opera_designer_gig.design_role/opera.opera_designer_gig.opera	opera.opera_designer_role	opera.opera_production
opera.opera_designer_gig.opera/opera.opera_designer_gig.designer	opera.opera_production	opera.opera_designer
people.appointment.appointed_by/people.appointment.appointed_role	people.appointer	people.appointed_role
people.appointment.appointed_by/people.appointment.appointee	people.appointer	people.appointee
people.appointment.appointed_role/people.appointment.appointee	people.appointed_role	people.appointee
projects.project_participation.participant/projects.project_participation.project	projects.project_participant	projects.project
projects.project_participation.participant/projects.project_participation.role	projects.project_participant	projects.project_role
projects.project_participation.project/projects.project_participation.role	projects.project	projects.project_role
protected_sites.natural_or_cultural_site_listing.category_or_criteria/protected_sites.natural_or_cultural_site_listing.designation	protected_sites.site_listing_category	protected_sites.natural_or_cultural_site_designation
protected_sites.natural_or_cultural_site_listing.category_or_criteria/protected_sites.natural_or_cultural_site_listing.listed_site	protected_sites.site_listing_category	protected_sites.listed_site
protected_sites.natural_or_cultural_site_listing.designation/protected_sites.natural_or_cultural_site_listing.listed_site	protected_sites.natural_or_cultural_site_designation	protected_sites.listed_site
royalty.chivalric_order_membership.order/royalty.chivalric_order_membership.presented_by	royalty.order_of_chivalry	royalty.chivalric_order_officer
royalty.chivalric_order_membership.order/royalty.chivalric_order_membership.recipient	royalty.order_of_chivalry	royalty.chivalric_order_member
royalty.chivalric_order_membership.order/royalty.chivalric_order_membership.title	royalty.order_of_chivalry	royalty.chivalric_title
royalty.chivalric_order_membership.presented_by/royalty.chivalric_order_membership.recipient	royalty.chivalric_order_officer	royalty.chivalric_order_member
royalty.chivalric_order_membership.title/royalty.chivalric_order_membership.presented_by	royalty.chivalric_title	royalty.chivalric_order_officer
royalty.chivalric_order_membership.title/royalty.chivalric_order_membership.recipient	royalty.chivalric_title	royalty.chivalric_order_member
royalty.chivalric_order_relationship.higher_order/royalty.chivalric_order_relationship.lower_order	royalty.order_of_chivalry	royalty.order_of_chivalry
royalty.chivalric_order_relationship.higher_order/royalty.chivalric_order_relationship.system_of_nobility	royalty.order_of_chivalry	royalty.system_of_nobility
royalty.chivalric_order_relationship.lower_order/royalty.chivalric_order_relationship.system_of_nobility	royalty.order_of_chivalry	royalty.system_of_nobility
royalty.precedence.higher_rank/royalty.precedence.system	royalty.noble_rank	royalty.system_of_nobility
royalty.precedence.lower_rank/royalty.precedence.higher_rank	royalty.noble_rank	royalty.noble_rank
royalty.precedence.lower_rank/royalty.precedence.system	royalty.noble_rank	royalty.system_of_nobility
soccer.football_goal.match/soccer.football_goal.point_awarded_to	soccer.football_match	soccer.football_team
soccer.football_goal.scorer/soccer.football_goal.match	soccer.football_player	soccer.football_match
soccer.football_goal.scorer/soccer.football_goal.point_awarded_to	soccer.football_player	soccer.football_team
soccer.football_league_participation.from/soccer.football_league_participation.league	soccer.football_league_season	soccer.football_league
soccer.football_league_participation.from/soccer.football_league_participation.team	soccer.football_league_season	soccer.football_team
soccer.football_league_participation.from/soccer.football_league_participation.to	soccer.football_league_season	soccer.football_league_season
soccer.football_league_participation.team/soccer.football_league_participation.league	soccer.football_team	soccer.football_league
soccer.football_league_participation.to/soccer.football_league_participation.league	soccer.football_league_season	soccer.football_league
soccer.football_league_participation.to/soccer.football_league_participation.team	soccer.football_league_season	soccer.football_team
soccer.football_player_loan.lending_team/soccer.football_player_loan.borrowing_team	soccer.football_team	soccer.football_team
soccer.football_player_loan.player/soccer.football_player_loan.borrowing_team	soccer.football_player	soccer.football_team
soccer.football_player_loan.player/soccer.football_player_loan.lending_team	soccer.football_player	soccer.football_team
soccer.football_player_match_participation.player/soccer.football_player_match_participation.match	soccer.football_player	soccer.football_match
soccer.football_player_match_participation.team/soccer.football_player_match_participation.match	soccer.football_team	soccer.football_match
soccer.football_player_match_participation.team/soccer.football_player_match_participation.player	soccer.football_team	soccer.football_player
soccer.football_player_substitution.match/soccer.football_player_substitution.off	soccer.football_match	soccer.football_player
soccer.football_player_substitution.on/soccer.football_player_substitution.match	soccer.football_player	soccer.football_match
soccer.football_player_substitution.on/soccer.football_player_substitution.off	soccer.football_player	soccer.football_player
soccer.football_team_manager_match_participation.match/soccer.football_team_manager_match_participation.manager	soccer.football_match	soccer.football_team_manager
soccer.football_team_manager_match_participation.match/soccer.football_team_manager_match_participation.team	soccer.football_match	soccer.football_team
soccer.football_team_manager_match_participation.team/soccer.football_team_manager_match_participation.manager	soccer.football_team	soccer.football_team_manager
spaceflight.rocket_stage.engine/spaceflight.rocket_stage.fuel	spaceflight.rocket_engine	spaceflight.rocket_fuel
spaceflight.rocket_stage.engine/spaceflight.rocket_stage.rocket	spaceflight.rocket_engine	spaceflight.rocket
spaceflight.rocket_stage.fuel/spaceflight.rocket_stage.rocket	spaceflight.rocket_fuel	spaceflight.rocket
sports.competitor_country_relationship.competitor/sports.competitor_country_relationship.country	sports.tournament_event_competitor	sports.sport_country
sports.competitor_country_relationship.competitor/sports.competitor_country_relationship.sports	sports.tournament_event_competitor	sports.sport
sports.competitor_country_relationship.competitor/sports.competitor_country_relationship.tournament	sports.tournament_event_competitor	sports.multi_event_tournament
sports.competitor_country_relationship.sports/sports.competitor_country_relationship.country	sports.sport	sports.sport_country
sports.competitor_country_relationship.tournament/sports.competitor_country_relationship.country	sports.multi_event_tournament	sports.sport_country
sports.competitor_country_relationship.tournament/sports.competitor_country_relationship.sports	sports.multi_event_tournament	sports.sport
sports.sports_award.award_winner/sports.sports_award.award	sports.sports_award_winner	sports.sports_award_type
sports.sports_award.award_winner/sports.sports_award.team	sports.sports_award_winner	sports.sports_team
sports.sports_award.season/sports.sports_award.award	sports.sports_league_season	sports.sports_award_type
sports.sports_award.season/sports.sports_award.award_winner	sports.sports_league_season	sports.sports_award_winner
sports.sports_award.season/sports.sports_award.team	sports.sports_league_season	sports.sports_team
sports.sports_award.team/sports.sports_award.award	sports.sports_team	sports.sports_award_type
sports.sports_league_draft_pick.player/sports.sports_league_draft_pick.draft	sports.drafted_athlete	sports.sports_league_draft
sports.sports_league_draft_pick.player/sports.sports_league_draft_pick.school	sports.drafted_athlete	education.educational_institution
sports.sports_league_draft_pick.player/sports.sports_league_draft_pick.team	sports.drafted_athlete	sports.professional_sports_team
sports.sports_league_draft_pick.school/sports.sports_league_draft_pick.draft	education.educational_institution	sports.sports_league_draft
sports.sports_league_draft_pick.school/sports.sports_league_draft_pick.team	education.educational_institution	sports.professional_sports_team
sports.sports_league_draft_pick.team/sports.sports_league_draft_pick.draft	sports.professional_sports_team	sports.sports_league_draft
sports.sports_league_participation.from/sports.sports_league_participation.league	sports.sports_league_season	sports.sports_league
sports.sports_league_participation.from/sports.sports_league_participation.team	sports.sports_league_season	sports.sports_team
sports.sports_league_participation.from/sports.sports_league_participation.to	sports.sports_league_season	sports.sports_league_season
sports.sports_league_participation.league/sports.sports_league_participation.team	sports.sports_league	sports.sports_team
sports.sports_league_participation.league/sports.sports_league_participation.to	sports.sports_league	sports.sports_league_season
sports.sports_league_participation.to/sports.sports_league_participation.team	sports.sports_league_season	sports.sports_team
tennis.tennis_match.event/tennis.tennis_match.winner	tennis.tennis_tournament	tennis.tennis_player
tennis.tennis_match.loser/tennis.tennis_match.event	tennis.tennis_player	tennis.tennis_tournament
tennis.tennis_match.loser/tennis.tennis_match.winner	tennis.tennis_player	tennis.tennis_player
theater.theater_designer_gig.designer/theater.theater_designer_gig.play	theater.theater_designer	theater.theater_production
theater.theater_designer_gig.design_role/theater.theater_designer_gig.designer	theater.theater_designer_role	theater.theater_designer
theater.theater_designer_gig.design_role/theater.theater_designer_gig.play	theater.theater_designer_role	theater.theater_production
theater.theater_production_staff_gig.play/theater.theater_production_staff_gig.production_role	theater.theater_production	theater.theater_production_staff_role
theater.theater_production_staff_gig.play/theater.theater_production_staff_gig.staff_member	theater.theater_production	theater.theater_production_staff
theater.theater_production_staff_gig.staff_member/theater.theater_production_staff_gig.production_role	theater.theater_production_staff	theater.theater_production_staff_role
theater.theater_role.actor/theater.theater_role.play	theater.theater_actor	theater.theater_production
theater.theater_role.actor/theater.theater_role.role	theater.theater_actor	theater.theater_character
theater.theater_role.role/theater.theater_role.play	theater.theater_character	theater.theater_production
travel.transportation.mode_of_transportation/travel.transportation.transport_operator	travel.transportation_mode	travel.transport_operator
travel.transportation.transport_terminus/travel.transportation.mode_of_transportation	travel.transport_terminus	travel.transportation_mode
travel.transportation.transport_terminus/travel.transportation.transport_operator	travel.transport_terminus	travel.transport_operator
travel.transportation.travel_destination/travel.transportation.mode_of_transportation	travel.travel_destination	travel.transportation_mode
travel.transportation.travel_destination/travel.transportation.transport_operator	travel.travel_destination	travel.transport_operator
travel.transportation.travel_destination/travel.transportation.transport_terminus	travel.travel_destination	travel.transport_terminus
tv.regular_tv_appearance.actor/tv.regular_tv_appearance.character	tv.tv_actor	tv.tv_character
tv.regular_tv_appearance.actor/tv.regular_tv_appearance.seasons	tv.tv_actor	tv.tv_series_season
tv.regular_tv_appearance.actor/tv.regular_tv_appearance.series	tv.tv_actor	tv.tv_program
tv.regular_tv_appearance.character/tv.regular_tv_appearance.seasons	tv.tv_character	tv.tv_series_season
tv.regular_tv_appearance.character/tv.regular_tv_appearance.series	tv.tv_character	tv.tv_program
tv.regular_tv_appearance.seasons/tv.regular_tv_appearance.series	tv.tv_series_season	tv.tv_program
tv.tv_crew_gig.crewmember/tv.tv_crew_gig.episode	tv.tv_crewmember	tv.tv_series_episode
tv.tv_crew_gig.crewmember/tv.tv_crew_gig.tv_crew_role	tv.tv_crewmember	tv.tv_crew_role
tv.tv_crew_gig.tv_crew_role/tv.tv_crew_gig.episode	tv.tv_crew_role	tv.tv_series_episode
tv.tv_guest_role.actor/tv.tv_guest_role.character	tv.tv_actor	tv.tv_character
tv.tv_guest_role.episodes_appeared_in/tv.tv_guest_role.actor	tv.tv_series_episode	tv.tv_actor
tv.tv_guest_role.episodes_appeared_in/tv.tv_guest_role.character	tv.tv_series_episode	tv.tv_character
tv.tv_regular_personal_appearance.program/tv.tv_regular_personal_appearance.person	tv.tv_program	tv.tv_personality
tv.tv_regular_personal_appearance.program/tv.tv_regular_personal_appearance.seasons	tv.tv_program	tv.tv_series_season
tv.tv_regular_personal_appearance.seasons/tv.tv_regular_personal_appearance.person	tv.tv_series_season	tv.tv_personality
tv.tv_segment_performance.character/tv.tv_segment_performance.actor	tv.tv_character	tv.tv_actor
tv.tv_segment_performance.character/tv.tv_segment_performance.segment	tv.tv_character	tv.tv_episode_segment
tv.tv_segment_performance.segment/tv.tv_segment_performance.actor	tv.tv_episode_segment	tv.tv_actor
user.ajain.default_domain.admission_requirements.academic_institution/user.ajain.default_domain.admission_requirements.degree	education.academic_institution	education.educational_degree
user.ajain.default_domain.admission_requirements.academic_institution/user.ajain.default_domain.admission_requirements.degree_requirement	education.academic_institution	education.educational_degree
user.ajain.default_domain.admission_requirements.academic_institution/user.ajain.default_domain.admission_requirements.department	education.academic_institution	education.department
user.ajain.default_domain.admission_requirements.academic_institution/user.ajain.default_domain.admission_requirements.major_requirement	education.academic_institution	education.field_of_study
user.ajain.default_domain.admission_requirements.academic_institution/user.ajain.default_domain.admission_requirements.standardized_test_requirement	education.academic_institution	base.standardizedtesting.standardized_test
user.ajain.default_domain.admission_requirements.degree_requirement/user.ajain.default_domain.admission_requirements.degree	education.educational_degree	education.educational_degree
user.ajain.default_domain.admission_requirements.degree_requirement/user.ajain.default_domain.admission_requirements.department	education.educational_degree	education.department
user.ajain.default_domain.admission_requirements.degree_requirement/user.ajain.default_domain.admission_requirements.major_requirement	education.educational_degree	education.field_of_study
user.ajain.default_domain.admission_requirements.department/user.ajain.default_domain.admission_requirements.degree	education.department	education.educational_degree
user.ajain.default_domain.admission_requirements.major_requirement/user.ajain.default_domain.admission_requirements.degree	education.field_of_study	education.educational_degree
user.ajain.default_domain.admission_requirements.major_requirement/user.ajain.default_domain.admission_requirements.department	education.field_of_study	education.department
user.ajain.default_domain.admission_requirements.standardized_test_requirement/user.ajain.default_domain.admission_requirements.degree	base.standardizedtesting.standardized_test	education.educational_degree
user.ajain.default_domain.admission_requirements.standardized_test_requirement/user.ajain.default_domain.admission_requirements.degree_requirement	base.standardizedtesting.standardized_test	education.educational_degree
user.ajain.default_domain.admission_requirements.standardized_test_requirement/user.ajain.default_domain.admission_requirements.department	base.standardizedtesting.standardized_test	education.department
user.ajain.default_domain.admission_requirements.standardized_test_requirement/user.ajain.default_domain.admission_requirements.major_requirement	base.standardizedtesting.standardized_test	education.field_of_study
user.ajain.default_domain.app_deadline.academic_institution/user.ajain.default_domain.app_deadline.degree	user.ajain.default_domain.academic_institution_extra	education.educational_degree
user.ajain.default_domain.app_deadline.academic_institution/user.ajain.default_domain.app_deadline.program	user.ajain.default_domain.academic_institution_extra	education.field_of_study
user.ajain.default_domain.app_deadline.program/user.ajain.default_domain.app_deadline.degree	education.field_of_study	education.educational_degree
user.alecf.car_sharing.vehicle_location_value.location/user.alecf.car_sharing.vehicle_location_value.metro_agency	user.alecf.car_sharing.share_location	user.alecf.car_sharing.metro_agency
user.alecf.car_sharing.vehicle_location_value.vehicle/user.alecf.car_sharing.vehicle_location_value.location	user.alecf.car_sharing.vehicle	user.alecf.car_sharing.share_location
user.alecf.car_sharing.vehicle_location_value.vehicle/user.alecf.car_sharing.vehicle_location_value.metro_agency	user.alecf.car_sharing.vehicle	user.alecf.car_sharing.metro_agency
user.alexbl.honorary_title.honorary_title_holding.conferred_by/user.alexbl.honorary_title.honorary_title_holding.conferred_upon	user.alexbl.honorary_title.title_presenter	user.alexbl.honorary_title.titled_person
user.alexbl.honorary_title.honorary_title_holding.conferred_by/user.alexbl.honorary_title.honorary_title_holding.honorary_title	user.alexbl.honorary_title.title_presenter	user.alexbl.honorary_title.honorary_title
user.alexbl.honorary_title.honorary_title_holding.conferred_upon/user.alexbl.honorary_title.honorary_title_holding.honorary_title	user.alexbl.honorary_title.titled_person	user.alexbl.honorary_title.honorary_title
user.cip22.default_domain.musical_contribution.plays/user.cip22.default_domain.musical_contribution.musician	music.instrument	music.artist
user.cip22.default_domain.musical_contribution.plays/user.cip22.default_domain.musical_contribution.track	music.instrument	user.cip22.default_domain.recorded_track
user.cip22.default_domain.musical_contribution.track/user.cip22.default_domain.musical_contribution.musician	user.cip22.default_domain.recorded_track	music.artist
user.robert.mobile_phones.regional_submodel.mobile_phone/user.robert.mobile_phones.regional_submodel.band	user.robert.mobile_phones.mobile_phone	user.robert.mobile_phones.band_encoding
user.robert.mobile_phones.regional_submodel.mobile_phone/user.robert.mobile_phones.regional_submodel.region	user.robert.mobile_phones.mobile_phone	user.robert.mobile_phones.mobile_phone_region
user.robert.mobile_phones.regional_submodel.region/user.robert.mobile_phones.regional_submodel.band	user.robert.mobile_phones.mobile_phone_region	user.robert.mobile_phones.band_encoding
user.robert.performance.performance.other_performers/user.robert.performance.performance.headliner	user.robert.performance.performer	user.robert.performance.performer
user.robert.performance.performance.other_performers/user.robert.performance.performance.venue	user.robert.performance.performer	user.robert.performance.performance_venue
user.robert.performance.performance.venue/user.robert.performance.performance.headliner	user.robert.performance.performance_venue	user.robert.performance.performer
user.skud.embassies_and_consulates.ambassadorial_tenure.ambassador/user.skud.embassies_and_consulates.ambassadorial_tenure.attached_to_embassy	user.skud.embassies_and_consulates.ambassador	user.skud.embassies_and_consulates.embassy
user.skud.embassies_and_consulates.ambassadorial_tenure.to_countries/user.skud.embassies_and_consulates.ambassadorial_tenure.ambassador	location.country	user.skud.embassies_and_consulates.ambassador
user.skud.embassies_and_consulates.ambassadorial_tenure.to_countries/user.skud.embassies_and_consulates.ambassadorial_tenure.attached_to_embassy	location.country	user.skud.embassies_and_consulates.embassy
user.szaijan.fantasy_football.projection.player/user.szaijan.fantasy_football.projection.scoring	user.szaijan.fantasy_football.player	user.szaijan.fantasy_football.scoring
user.szaijan.fantasy_football.projection.season/user.szaijan.fantasy_football.projection.player	user.szaijan.fantasy_football.season	user.szaijan.fantasy_football.player
user.szaijan.fantasy_football.projection.season/user.szaijan.fantasy_football.projection.scoring	user.szaijan.fantasy_football.season	user.szaijan.fantasy_football.scoring
